1111111111
1P000000E1
1000110001
1000000001
1000000001
1111C11111
1111111111