1111111111
1P000000E1
1000110001
1C000000C1
1000000001
1111111111
