11111111111111111111
1000000P0000000010E1
10000000110001000001
1C00000C0000010010C1
10000000000100001001
11111111111111111111