1111111111
1P000100E1
1000010001
1C010000C1
1000000001
1111111111
