111111111111111111111111111111
10000000000000000P0000000010E1
100000000000000000110001000001
1C000000000000000C0000010010C1
100000000000000000000100001001
100000000000000000000100001001
100000000000000000000100001001
100000000000000000000100001001
100000000000000000000100001001
100000000000000000000100001001
100000000000000000000100001001
100000000000000000000100001001
100000000000000000000100001001
100000000000000000000100001001
100000000000000000000100001001
100000000000000000000100001001
100000000000000000000100001001
100000000000000000000100001001
100000000000000000000100001001
100000000000000000000100001001
100000000000000000000100001001
100000000000000000000100001001
100000000000000000000100001001
111111111111111111111111111111