1111111111
1000010001
100P010001
1000010001
10000E0C01
1111111111