1111111111
1000000001
100P000C01
1111111111
10E0000001
1111111111
