1111111111
1P000100C1
1000010001
1C0101E111
1000000001
1111111111
