1111111111
1000010001
100P010001
1000010001
10E0010C01
1111111111