1111111111
1000000001
100P0000001
1000000001
10E0000Z01
1111111111