11111111111
1P00P0000E1
10000110001
1C00C0000C1
10000000001
11111111111